0500 0500 0500 0500 0500 0500 0500 0503 0700 0500 0500 0500 0500 0500 0500 0500 0500 0500 
0000 0000 0000 0000 0000 0000 0000 0000 0800 0000 0000 0000 0000 0000 0000 0000 0000 0000 
0500 0500 0500 0500 0500 0500 0500 0503 0500 0500 0500 0500 0500 0500 0500 0500 0500 0500 
0500 0500 0500 0500 0500 0000 0000 0000 0000 0000 0000 0000 0000 0000 0000 0000 0000 0000 
0000 0000 0500 0500 0500 0700 0500 0500 0500 0500 0500 0000 0000 0000 0000 0000 0000 0000 
0000 0000 0000 0000 0000 0800 0000 0000 0500 0500 0500 0500 0500 0500 0500 0500 0500 0500 
0000 0000 0000 0000 0000 0800 0000 0000 0000 0500 0500 0000 0500 0500 0500 0500 0500 0000 
0000 0000 0000 0000 0000 0800 0000 0000 0000 0000 0000 0000 0000 0500 0500 0500 0000 0000 
0500 0500 0500 0500 0500 0500 0500 0000 0000 0000 0000 0000 0000 0000 0000 0000 0000 0000
0000 0000 0000 0000 0000 0500 0500 0500 0500 0500 0500 0000 0000 0000 0000 0000 0000 0000
0000 0000 0000 0000 0000 0000 0000 0000 0000 0500 0500 0000 0000 0000 0000 0000 0000 0000
0000 0000 0000 0000 0000 0000 0000 0000 0000 0500 0500 0000 0000 0000 0000 0000 0000 0000
0500 0500 0500 0500 0500 0500 0700 0503 0500 0500 0500 0500 0500 0500 0500 0500 0500 0500 