0500 0502 0500 0500 0500 0500 0700 0502 0500 0500 0500 0500 0500 0500 0500 0500 0500 0500
0502 0000 0500 0502 0000 0000 0800 0000 0000 0600 0600 0600 0501 0600 0600 0001 0502 0500
0000 0000 0000 0000 0000 0000 0800 0000 0000 0000 0600 0600 0600 0600 0000 0000 0000 0000
0000 0000 0000 0005 0300 0006 0800 0000 0000 0000 0002 0600 0600 0000 0000 0000 0000 0000
0000 0000 0505 0700 0500 0500 0503 0500 0500 0700 0500 0505 0600 0000 0000 0000 0000 0000
0000 0000 0000 0800 0000 0000 0005 0000 0000 0800 0000 0000 0000 0000 0000 0000 0000 0000
0002 0000 0000 0800 0003 0000 0000 0000 0000 0800 0000 0000 0000 0000 0000 0000 0002 0002
0002 0002 0000 0800 0004 0000 0000 0000 0000 0800 0000 0000 0504 0500 0700 0502 0500 0500
0500 0504 0500 0500 0505 0003 0000 0000 0000 0800 0000 0000 0000 0000 0800 0000 0000 0000
0000 0005 0000 0000 0000 0000 0000 0500 0700 0505 0000 0000 0000 0000 0800 0002 0002 0002
0000 0000 0000 0000 0000 0000 0000 0000 0800 0000 0000 0000 0600 0600 0502 0500 0500 0500
0000 0000 0000 0000 0000 0000 0000 0000 0800 0000 0000 0000 0600 0502 0500 0500 0500 0500
0500 0500 0500 0500 0500 0500 0500 0500 0500 0500 0500 0502 0500 0500 0500 0500 0500 0500