0500 0500 0502 0500 0500 0500 0502 0500 0500 0500 0500 0500 0500 0500 0500 0500 0500 0500
0500 0502 0000 0600 0600 0600 0600 0600 0600 0600 0600 0500 0500 0600 0600 0600 0500 0500
0000 0000 0000 0000 0000 0600 0600 0600 0600 0600 0002 0002 0502 0500 0600 0600 0500 0500
0003 0000 0000 0000 0000 0000 0000 0600 0600 0002 0000 0000 0002 0500 0500 0600 0600 0500
0004 0003 0300 0000 0000 0000 0000 0000 0000 0000 0000 0000 0000 0502 0500 0600 0600 0500
0504 0500 0505 0503 0000 0000 0000 0000 0000 0000 0002 0000 0000 0002 0500 0600 0500 0500
0000 0000 0005 0004 0000 0000 0000 0000 0002 0600 0600 0000 0000 0002 0600 0600 0500 0500
0000 0000 0000 0000 0000 0000 0000 0002 0600 0600 0002 0000 0002 0002 0600 0600 0600 0500
0000 0000 0000 0000 0000 0000 0000 0000 0000 0000 0000 0002 0002 0600 0600 0600 0600 0500
0000 0000 0000 0000 0000 0000 0000 0000 0000 0002 0002 0002 0600 0600 0600 0600 0600 0500
0000 0000 0000 0000 0000 0000 0000 0002 0002 0002 0501 0600 0600 0600 0600 0600 0600 0500
0000 0000 0000 0000 0000 0002 0502 0502 0500 0500 0500 0500 0500 0502 0600 0600 0500 0500
0500 0500 0502 0500 0500 0500 0500 0500 0500 0500 0500 0500 0500 0500 0500 0500 0500 0500