0500 0000 0000 0000 0000 0000 0000 0000 0000 0000 0000 0000 0000 0000 0000 0000 0800 0502
0500 0000 0000 0000 0000 0000 0000 0000 0000 0000 0000 0000 0000 0000 0000 0000 0800 0500
0500 0000 0000 0000 0000 0000 0003 0000 0000 0000 0000 0000 0000 0000 0000 0000 0800 0000
0502 0000 0503 0700 0500 0500 0504 0000 0003 0000 0000 0000 0000 0000 0000 0000 0800 0000
0500 0000 0000 0800 0000 0000 0004 0005 0004 0000 0000 0000 0000 0000 0000 0000 0800 0000
0500 0000 0000 0800 0000 0000 0000 0000 0005 0000 0005 0000 0000 0000 0000 0502 0500 0503
0500 0000 0000 0800 0000 0000 0000 0000 0000 0000 0000 0000 0000 0000 0000 0000 0500 0000
0500 0000 0000 0800 0000 0000 0000 0000 0000 0000 0000 0000 0000 0000 0000 0000 0004 0000
0500 0000 0000 0800 0000 0000 0000 0000 0000 0000 0501 0500 0500 0502 0000 0000 0000 0000
0500 0700 0500 0504 0000 0000 0000 0000 0000 0000 0000 0500 0502 0000 0000 0000 0000 0000
0500 0800 0505 0000 0000 0000 0000 0000 0000 0000 0000 0000 0000 0000 0000 0000 0000 0000
0502 0800 0000 0000 0000 0000 0000 0000 0000 0000 0000 0000 0000 0000 0000 0000 0000 0000
0500 0800 0000 0000 0500 0505 0500 0000 0000 0000 0000 0000 0000 0000 0000 0000 0500 0500