0500 0500 0500 0500 0502 0500 0500 0500 0500 0500 0500 0500 0500 0500 0502 0500 0500 0500
0500 0500 0500 0502 0000 0502 0500 0000 0000 0000 0000 0000 0000 0502 0000 0502 0500 0500
0500 0000 0501 0000 0000 0000 0000 0000 0000 0000 0003 0000 0000 0000 0000 0000 0502 0500
0500 0000 0000 0000 0000 0000 0000 0000 0005 0003 0004 0003 0000 0000 0000 0003 0002 0500
0500 0000 0000 0000 0000 0000 0000 0000 0000 0000 0000 0000 0000 0000 0000 0000 0000 0000
0500 0000 0000 0000 0000 0000 0000 0003 0503 0005 0504 0003 0503 0500 0500 0700 0500 0500
0500 0000 0100 0100 0100 0000 0000 0000 0004 0000 0005 0003 0504 0500 0000 0800 0000 0500
0500 0700 0504 0500 0500 0503 0600 0000 0004 0000 0000 0000 0505 0000 0000 0800 0000 0500
0500 0800 0505 0000 0600 0600 0600 0000 0000 0000 0000 0000 0600 0501 0800 0000 0500 0500
0500 0800 0000 0000 0000 0600 0000 0000 0000 0000 0000 0000 0600 0000 0800 0000 0000 0000
0500 0800 0000 0000 0000 0000 0000 0000 0100 0100 0200 0600 0600 0000 0800 0000 0000 0000
0500 0800 0000 0000 0000 0000 0000 0502 0500 0500 0500 0600 0600 0500 0500 0500 0000 0000
0500 0500 0500 0500 0500 0502 0502 0500 0500 0500 0500 0500 0500 0500 0500 0500 0500 0500