0500 0500 0500 0500 0500 0500 0500 0500 0500 0500 0500 0500 0500 0500 0500 0500 0500 0500 
0500 0000 0000 0000 0000 0000 0000 0000 0000 0000 0000 0000 0000 0000 0000 0000 0000 0500
0500 0000 0000 0000 0000 0000 0000 0000 0000 0000 0000 0000 0000 0000 0000 0000 0000 0500
0500 0000 0000 0500 0500 0500 0000 0000 0000 0000 0000 0000 0500 0500 0500 0000 0000 0500
0500 0000 0000 0000 0000 0000 0000 0000 0000 0000 0000 0000 0000 0000 0000 0000 0000 0500
0500 0000 0000 0000 0000 0000 0000 0500 0500 0500 0500 0000 0000 0000 0000 0000 0000 0500
0500 0000 0000 0000 0000 0000 0000 0000 0000 0000 0000 0000 0000 0000 0000 0000 0000 0500
0500 0000 0000 0000 0000 0000 0000 0000 0000 0000 0000 0000 0000 0000 0000 0000 0000 0500
0500 0000 0000 0500 0500 0500 0500 0000 0000 0000 0000 0500 0500 0500 0500 0000 0000 0500
0500 0000 0000 0000 0000 0000 0000 0000 0000 0000 0000 0000 0000 0000 0000 0000 0000 0500
0500 0000 0000 0000 0000 0000 0000 0000 0000 0000 0000 0000 0000 0000 0000 0000 0000 0500
0500 0500 0500 0500 0500 0500 0500 0500 0500 0700 0500 0500 0500 0500 0500 0500 0500 0500
0500 0000 0000 0000 0000 0000 0000 0000 0000 0800 0000 0000 0000 0000 0000 0000 0000 0500
