0500 0500 0500 0500 0500 0500 0500 0500 0500 0500 0500 0500 0500 0500 0500 0500 0500 0500
0500 0502 0002 0500 0002 0000 0502 0500 0500 0500 0000 0000 0000 0000 0000 0000 0002 0501
0500 0002 0000 0000 0000 0000 0000 0000 0000 0000 0000 0000 0000 0000 0000 0002 0002 0500
0500 0002 0002 0000 0000 0000 0000 0000 0000 0000 0000 0000 0002 0600 0600 0500 0500 0500
0500 0600 0600 0600 0600 0500 0503 0000 0502 0700 0505 0500 0500 0500 0500 0500 0500 0500
0500 0500 0600 0600 0000 0000 0000 0000 0000 0800 0000 0000 0000 0000 0003 0000 0001 0500
0500 0500 0600 0600 0000 0000 0000 0000 0000 0800 0000 0000 0503 0500 0505 0700 0500 0500
0503 0502 0000 0600 0600 0000 0000 0000 0000 0800 0000 0000 0005 0500 0500 0800 0500 0500
0504 0000 0000 0600 0600 0505 0700 0500 0504 0500 0500 0000 0000 0500 0504 0800 0000 0500
0000 0003 0000 0000 0600 0000 0800 0000 0000 0000 0000 0000 0000 0500 0000 0800 0000 0000
0000 0005 0000 0000 0000 0000 0800 0000 0000 0000 0000 0000 0502 0500 0000 0800 0000 0000
0000 0002 0002 0000 0000 0000 0800 0000 0000 0000 0000 0502 0500 0502 0000 0800 0000 0000
0504 0505 0502 0500 0500 0500 0500 0500 0500 0500 0500 0500 0500 0500 0500 0500 0500 0500