0500 0500 0500 0500 0500 0500 0500 0500 0500 0500 0500 0500 0500 0500 0500 0500 0500 0500
0500 0500 0502 0600 0600 0000 0000 0000 0000 0000 0000 0000 0000 0000 0000 0000 0000 0000
0500 0500 0002 0600 0000 0000 0002 0002 0000 0000 0000 0000 0000 0000 0000 0000 0000 0000
0500 0502 0001 0000 0002 0002 0500 0500 0500 0500 0000 0505 0700 0500 0502 0000 0000 0000
0500 0002 0000 0002 0002 0600 0600 0000 0000 0000 0000 0000 0800 0000 0500 0000 0000 0000
0502 0002 0002 0002 0600 0600 0600 0000 0000 0003 0000 0000 0800 0003 0500 0000 0000 0000
0502 0002 0002 0502 0500 0500 0500 0500 0700 0505 0500 0500 0500 0504 0500 0000 0000 0000
0500 0002 0502 0501 0500 0500 0500 0000 0800 0000 0000 0000 0000 0000 0500 0000 0000 0000
0502 0002 0002 0000 0502 0502 0500 0004 0800 0000 0000 0000 0000 0000 0500 0000 0001 0000
0500 0502 0002 0002 0000 0000 0500 0505 0500 0500 0005 0503 0700 0500 0500 0502 0501 0502
0500 0500 0502 0002 0002 0002 0000 0000 0000 0000 0000 0004 0800 0000 0600 0600 0600 0000
0500 0500 0500 0502 0002 0002 0002 0000 0000 0000 0000 0005 0800 0000 0000 0600 0600 0000
0500 0500 0500 0500 0500 0500 0500 0500 0500 0500 0500 0500 0500 0500 0500 0500 0500 0500