0500 0500 0500 0500 0500 0500 0500 0502 0500 0500 0500 0500 0500 0500 0500 0500 0500 0500
0500 0500 0501 0502 0502 0500 0502 0002 0502 0000 0000 0000 0000 0000 0000 0000 0000 0000
0500 0500 0502 0002 0502 0600 0000 0000 0000 0000 0000 0000 0003 0000 0000 0000 0502 0500
0500 0502 0002 0002 0600 0600 0600 0600 0600 0600 0500 0700 0504 0500 0600 0600 0600 0502
0501 0502 0002 0002 0600 0001 0600 0600 0600 0000 0000 0800 0005 0600 0600 0000 0000 0000
0502 0002 0002 0002 0600 0000 0000 0000 0600 0000 0000 0800 0000 0600 0000 0000 0000 0000
0502 0502 0700 0502 0500 0000 0000 0000 0600 0503 0700 0505 0504 0600 0000 0000 0000 0000
0500 0000 0800 0000 0000 0000 0300 0000 0000 0000 0800 0000 0000 0000 0000 0000 0000 0000
0500 0500 0500 0500 0500 0500 0500 0600 0600 0502 0500 0500 0500 0500 0500 0500 0500 0500
0500 0001 0000 0600 0500 0502 0600 0600 0600 0600 0000 0000 0502 0600 0600 0000 0000 0000
0500 0000 0000 0000 0000 0000 0000 0000 0000 0000 0000 0000 0000 0000 0000 0000 0000 0000
0500 0000 0200 0000 0200 0000 0000 0000 0000 0000 0000 0000 0000 0000 0000 0000 0000 0000
0500 0500 0500 0500 0500 0500 0500 0500 0500 0500 0500 0500 0500 0500 0500 0500 0500 0500