0500 0500 0500 0502 0500 0500 0500 0500 0502 0500 0700 0502 0500 0500 0500 0502 0500 0500
0502 0500 0500 0000 0000 0000 0000 0000 0000 0000 0800 0000 0000 0000 0600 0600 0600 0500
0000 0502 0000 0000 0000 0000 0000 0000 0000 0000 0800 0000 0000 0000 0000 0600 0600 0500
0000 0000 0000 0000 0000 0500 0502 0700 0500 0500 0500 0500 0502 0000 0000 0600 0600 0502
0000 0000 0000 0000 0000 0600 0000 0800 0000 0000 0000 0000 0600 0000 0000 0000 0600 0000
0000 0000 0000 0600 0600 0600 0000 0800 0000 0000 0000 0000 0600 0000 0000 0005 0600 0001
0002 0000 0003 0600 0000 0000 0000 0800 0000 0000 0000 0000 0500 0500 0700 0505 0500 0501
0503 0500 0505 0500 0500 0500 0500 0500 0500 0500 0700 0500 0500 0005 0800 0000 0000 0502
0000 0000 0000 0000 0000 0000 0000 0000 0000 0000 0800 0000 0000 0000 0800 0000 0000 0500
0002 0002 0000 0000 0000 0000 0000 0000 0000 0000 0800 0000 0000 0000 0800 0000 0000 0502
0502 0500 0500 0505 0600 0600 0000 0000 0000 0503 0500 0500 0505 0000 0800 0000 0000 0000
0500 0500 0500 0600 0600 0600 0600 0000 0000 0004 0000 0000 0000 0000 0800 0000 0000 0000
0500 0500 0500 0500 0500 0500 0500 0502 0500 0500 0500 0500 0500 0500 0500 0500 0500 0500