0503 0500 0500 0502 0501 0500 0500 0500 0500 0500 0500 0500 0500 0500 0500 0500 0500 0501
0000 0000 0000 0000 0001 0500 0501 0500 0500 0502 0003 0502 0500 0500 0500 0500 0500 0500
0100 0100 0100 0000 0000 0500 0500 0500 0500 0005 0000 0000 0500 0500 0502 0000 0502 0000
0500 0500 0500 0500 0700 0502 0500 0500 0000 0000 0000 0000 0000 0502 0000 0003 0000 0000
0500 0000 0000 0000 0800 0500 0502 0000 0000 0000 0000 0000 0000 0000 0000 0000 0000 0000
0502 0000 0000 0000 0800 0500 0003 0000 0000 0000 0000 0000 0000 0000 0000 0000 0000 0002
0500 0000 0100 0100 0800 0500 0003 0000 0000 0000 0000 0000 0000 0000 0000 0000 0002 0002
0500 0700 0505 0500 0500 0502 0000 0000 0000 0000 0002 0002 0002 0002 0000 0002 0002 0002
0500 0800 0000 0000 0000 0000 0000 0000 0000 0503 0500 0700 0504 0500 0500 0500 0500 0500
0500 0800 0000 0000 0000 0000 0000 0000 0000 0000 0000 0800 0000 0000 0000 0000 0000 0000 
0502 0800 0000 0005 0000 0000 0000 0005 0000 0000 0000 0800 0000 0000 0000 0000 0000 0000 
0500 0800 0000 0000 0000 0000 0000 0400 0000 0000 0000 0800 0000 0000 0000 0000 0000 0000 
0500 0500 0500 0500 0500 0500 0501 0502 0500 0500 0500 0500 0500 0500 0500 0500 0502 0500 