0500 0500 0502 0700 0502 0500 0500 0500 0000 0000 0000 0000 0000 0500 0500 0500 0500 0500
0500 0502 0005 0800 0000 0000 0000 0000 0000 0000 0000 0000 0000 0000 0600 0600 0500 0500
0500 0003 0000 0800 0000 0000 0000 0000 0000 0000 0000 0000 0000 0000 0000 0000 0600 0500
0500 0000 0000 0800 0000 0000 0000 0000 0000 0000 0000 0000 0000 0000 0000 0000 0000 0500
0500 0000 0500 0500 0500 0000 0000 0000 0000 0000 0100 0100 0000 0000 0502 0500 0500 0500
0502 0000 0502 0500 0600 0000 0000 0000 0000 0005 0700 0505 0500 0000 0000 0000 0000 0500
0500 0003 0004 0600 0600 0000 0000 0000 0000 0000 0800 0000 0000 0000 0000 0000 0000 0500
0500 0000 0000 0600 0502 0500 0502 0000 0000 0000 0800 0000 0000 0003 0000 0000 0502 0500
0500 0000 0000 0502 0500 0500 0500 0000 0000 0000 0800 0005 0000 0004 0003 0500 0500 0500
0000 0000 0000 0000 0000 0000 0000 0000 0000 0000 0504 0700 0500 0505 0500 0500 0000 0000
0000 0000 0000 0000 0502 0500 0000 0000 0000 0000 0000 0800 0000 0000 0502 0500 0000 0000
0000 0000 0000 0502 0500 0500 0500 0000 0000 0000 0000 0800 0000 0000 0900 0000 0000 0000
0500 0500 0501 0500 0500 0500 0500 0500 0500 0500 0500 0500 0500 0500 0500 0500 0500 0500
