0500 0500 0502 0500 0500 0502 0500 0500 0502 0502 0500 0500 0500 0500 0500 0500 0500 0500
0500 0600 0600 0000 0600 0600 0502 0500 0000 0000 0000 0000 0000 0000 0000 0000 0000 0500
0500 0502 0000 0000 0000 0600 0600 0500 0000 0000 0000 0000 0000 0300 0000 0000 0000 0500
0502 0000 0000 0000 0000 0000 0600 0502 0000 0503 0700 0500 0504 0505 0500 0503 0700 0500
0000 0000 0000 0000 0000 0000 0001 0600 0000 0000 0800 0000 0600 0600 0600 0504 0800 0500
0000 0000 0000 0200 0000 0200 0001 0600 0000 0000 0800 0000 0600 0600 0600 0500 0800 0500
0501 0500 0500 0500 0500 0500 0500 0502 0700 0502 0500 0500 0500 0500 0500 0500 0800 0500
0500 0502 0000 0000 0000 0000 0000 0000 0700 0000 0000 0000 0000 0000 0000 0504 0800 0500
0500 0000 0000 0000 0000 0000 0000 0000 0800 0000 0000 0000 0000 0001 0000 0500 0800 0500
0502 0000 0000 0000 0503 0500 0500 0504 0500 0500 0500 0500 0500 0500 0500 0502 0800 0500
0000 0000 0000 0000 0000 0000 0000 0000 0000 0000 0000 0000 0000 0000 0000 0000 0800 0500
0000 0000 0000 0000 0000 0100 0100 0000 0000 0000 0000 0000 0000 0000 0000 0000 0800 0500
0500 0500 0502 0700 0502 0500 0500 0503 0000 0000 0000 0000 0000 0503 0500 0500 0500 0500

