0500 0500 0500 0500 0500 0500 0000 0000 0000 0000 0000 0000 0000 0000 0000 0000 0000 0500
0000 0000 0000 0000 0000 0500 0000 0000 0000 0000 0000 0000 0000 0000 0000 0000 0000 0500
0500 0500 0500 0500 0700 0502 0000 0000 0500 0503 0500 0500 0504 0000 0000 0000 0000 0500
0000 0000 0000 0000 0800 0600 0000 0000 0000 0004 0000 0000 0000 0000 0000 0000 0000 0500
0000 0000 0000 0000 0800 0600 0002 0002 0000 0000 0000 0000 0000 0000 0000 0000 0000 0502
0500 0500 0500 0500 0500 0600 0600 0600 0600 0600 0600 0600 0500 0700 0503 0000 0000 0500
0502 0002 0002 0502 0501 0500 0600 0600 0600 0600 0600 0600 0600 0800 0000 0000 0000 0500
0000 0000 0000 0002 0502 0500 0500 0600 0600 0600 0600 0002 0000 0800 0000 0000 0000 0500
0000 0000 0000 0000 0002 0500 0002 0000 0000 0000 0000 0000 0000 0800 0000 0000 0000 0500
0000 0000 0000 0000 0000 0502 0000 0000 0502 0502 0500 0500 0502 0500 0502 0000 0000 0500
0000 0000 0000 0000 0000 0000 0000 0000 0000 0000 0000 0000 0000 0000 0000 0000 0000 0500
0000 0000 0000 0000 0000 0000 0000 0000 0000 0000 0000 0000 0000 0000 0000 0000 0000 0500
0500 0500 0500 0500 0500 0500 0500 0500 0502 0500 0700 0502 0500 0500 0500 0500 0500 0500