0500 0500 0500 0500 0500 0500 0500 0505 0000 0800 0000 0500 0502 0500 0500 0500 0500 0500
0000 0502 0000 0502 0000 0000 0000 0000 0000 0800 0000 0000 0000 0000 0000 0502 0500 0500
0000 0000 0502 0000 0000 0000 0000 0000 0000 0800 0000 0000 0000 0000 0000 0000 0000 0502
0000 0000 0000 0000 0000 0000 0000 0100 0100 0800 0100 0100 0100 0100 0100 0000 0000 0000
0000 0000 0003 0100 0100 0000 0000 0503 0500 0500 0502 0500 0505 0500 0700 0500 0000 0000
0000 0000 0505 0504 0500 0000 0000 0003 0000 0000 0000 0500 0002 0000 0800 0000 0000 0000
0000 0000 0000 0000 0000 0000 0000 0000 0000 0000 0000 0500 0002 0000 0800 0000 0000 0000
0000 0000 0000 0000 0000 0000 0000 0000 0000 0000 0000 0502 0000 0000 0800 0000 0000 0000
0000 0000 0000 0000 0000 0000 0000 0502 0500 0502 0002 0500 0000 0000 0800 0100 0100 0000
0500 0502 0700 0500 0505 0500 0502 0500 0600 0600 0002 0502 0000 0000 0500 0502 0502 0500
0000 0000 0800 0000 0000 0000 0000 0500 0600 0600 0000 0502 0000 0000 0500 0500 0500 0500
0000 0000 0800 0000 0100 0000 0000 0000 0000 0000 0000 0000 0000 0000 0000 0000 0000 0500
0500 0500 0500 0500 0502 0500 0000 0000 0000 0000 0000 0000 0000 0000 0000 0000 0000 0500