0501 0500 0500 0500 0500 0500 0500 0500 0500 0500 0500 0500 0500 0500 0500 0500 0500 0500
0500 0500 0502 0000 0000 0000 0000 0000 0500 0500 0000 0000 0000 0000 0000 0000 0000 0000
0502 0000 0000 0000 0000 0000 0000 0000 0502 0500 0000 0000 0000 0000 0000 0000 0000 0000
0502 0005 0003 0000 0000 0000 0000 0003 0900 0002 0002 0002 0000 0000 0000 0300 0001 0000
0500 0700 0504 0600 0600 0000 0000 0504 0500 0500 0500 0502 0000 0000 0502 0500 0500 0500
0500 0800 0005 0000 0000 0000 0000 0000 0000 0000 0000 0502 0000 0000 0000 0000 0502 0500
0500 0800 0000 0000 0000 0000 0000 0000 0000 0000 0000 0500 0000 0000 0000 0000 0000 0500
0500 0800 0000 0000 0000 0000 0000 0000 0000 0000 0000 0502 0000 0000 0000 0000 0000 0500
0500 0800 0000 0000 0000 0000 0600 0600 0600 0000 0000 0000 0000 0000 0000 0000 0000 0502
0502 0800 0000 0000 0000 0000 0000 0000 0000 0000 0000 0000 0000 0000 0500 0503 0700 0500
0500 0500 0503 0600 0600 0000 0000 0000 0000 0000 0000 0000 0000 0000 0000 0000 0800 0500
0500 0000 0000 0000 0000 0000 0000 0000 0600 0600 0500 0502 0000 0000 0000 0000 0800 0502
0502 0000 0000 0000 0000 0000 0000 0000 0000 0000 0000 0000 0000 0000 0000 0000 0800 0500