0500 0800 0000 0000 0502 0500 0501 0500 0000 0000 0000 0000 0000 0000 0000 0000 0500 0500
0500 0800 0003 0000 0000 0000 0000 0500 0000 0000 0000 0000 0000 0000 0000 0000 0502 0500
0502 0504 0500 0600 0000 0000 0000 0600 0000 0000 0000 0000 0000 0002 0000 0000 0000 0502
0000 0000 0000 0000 0000 0000 0000 0600 0000 0000 0000 0000 0002 0002 0002 0000 0000 0502
0000 0000 0000 0000 0600 0600 0600 0600 0000 0000 0000 0000 0502 0500 0500 0002 0000 0500
0000 0000 0000 0000 0000 0000 0000 0600 0000 0000 0000 0000 0000 0002 0002 0002 0000 0500
0000 0000 0000 0600 0000 0000 0000 0500 0000 0000 0002 0000 0000 0000 0000 0002 0000 0500
0000 0000 0000 0000 0000 0000 0000 0500 0000 0000 0502 0000 0000 0000 0000 0000 0000 0500
0000 0100 0100 0000 0000 0000 0000 0500 0000 0000 0500 0002 0002 0000 0000 0000 0000 0500
0500 0502 0500 0502 0800 0500 0502 0502 0000 0000 0500 0600 0600 0000 0000 0000 0000 0500
0500 0600 0600 0600 0700 0000 0000 0000 0000 0002 0600 0600 0600 0000 0000 0000 0000 0500
0500 0501 0600 0600 0700 0000 0000 0000 0002 0002 0600 0600 0600 0002 0000 0200 0000 0500
0500 0500 0500 0500 0500 0500 0500 0500 0500 0500 0500 0500 0500 0500 0502 0502 0500 0500
